NO ./path_to_the_north_texture

SO ./path_to_the_south_texture


WE ./path_to_the_west_texture
EA ./path_to_the_east_texture
F 220,100,0
C 225,30,0

		0111111111       111111111111111
		1000000000111111100000001
		1011000001110000000000001
	11110000001 100000000000001
111111111011000001110000000000001
100000000011001110111111111111
1111011111111111100000010001
11110111111111011101010010001
11000000110101011100000010001
10000000000000001100000010001
10000000100000001101010010001
11000001 10101011111011110N0111
1111P111 1110101 101111010001
11111111 1111111 111111111111


11111111
10000001
11111111
