NO ./textures/HEDGE_1B.xpm
SO ./textures/HEDGE_2A.xpm


WE ./textures/TILE_1F.xpm
EA ./textures/TILE_1G.xpm
F 112,135,72
C 78,134,186

111111
110001
100001
10E001
111111