NO ./textures/HEDGE_1B.xpm
SO ./textures/HEDGE_2A.xpm


WE ./textures/TILE_1F.xpm
EA ./textures/TILE_1G.xpm


F 100,80,0
C 225,30,100

      1111111111111111111111111
      1000000000110000000000001
      1011000001110000000000001
      10010000000000000000000011
111111111011000001110000000000001
100000000011000001110111111111111
11110111111111011100000010001
11110111111111011101010010001
11000000110101011100000010001
10000000000000001100000010001
10000000000000001101010010001
11000001110101011111011110N0111
11110111 1110101 101111010001
1111111111111111111111111111