NO ./textures/HEDGE_1B.xpm
SO ./textures/HEDGE_2A.xpm


WE ./textures/TILE_1F.xpm
EA ./textures/TILE_1G.xpm
F 49,106,31
C 78,134,186

11111111111111
10000110000011
10000100000001
10000110000011
10000100000001
10000110000011
11110000N00011
11111111111111