NO ./textures/HEDGE_1B.xpm
SO ./textures/HEDGE_2A.xpm


WE ./textures/TILE_1F.xpm
EA ./textures/TILE_1G.xpm
F 49,106,31
C 78,134,186

111111
110101
100001
10N001
111111