NO ./path_to_the_north_texture

SO ./path_to_the_south_texture


WE ./path_to_the_west_texture
EA ./path_to_the_east_texture
F 220,100,0
C 225,30,0

11111111
1111 1111
100000000111111100000001
1011000001110000000000001
1110000001100000000000001
111111111011000001110000000000001
100000000011001110111111111111
1111011111111111100000010001
1111011111111101111111101010010001
11000000110101011  N  100000010001
10000000000000001   100000010001
1000000000000000111111101010010001
1100000110101011111011110N0111
111101111110101101111010001
111111111111
11111111
10000001
11111111
